destWidth 608
destHeight 416
map_width 30
map_height 20
tile_width 32
tile_height 32
solid_tiles
1, 2, 3, 4, 5, 6, 14, 15, 16, 17, 18, 20, 21, 22, 23, 24, 25, 33, 34, 35, 36, 37, 39, 40, 41, 42, 43, 44, 52, 53, 54, 55, 56, 58, 59, 60, 61, 62, 63, 71, 72, 73, 74, 75, 77, 78, 79, 80, 81, 82, 83, 84, 85, 86, 87, 90, 91, 92, 93, 94, 96, 97, 98, 99, 100, 101, 102, 103, 104, 105, 106, 109, 110, 111, 112, 113, 115, 116, 117, 118, 119, 120, 121, 122, 123, 124, 125, 126, 127, 128, 129, 130, 131, 132, 134, 135, 136, 137, 138, 139, 143, 144, 145, 146, 147, 148, 149, 150, 151, 153, 154, 155, 156, 157, 158, 159, 160, 161, 162, 163, 164, 165, 166, 167, 168, 169, 170, 173, 174, 175, 176, 177, 178, 179, 180, 181, 183, 184, 185, 186, 187, 188, 189, 192, 193, 194, 195, 196, 197, 198, 199, 200, 202, 203, 204, 205, 206, 207, 208, 211, 212, 213, 214, 215, 216, 217, 218, 219, 220, 221, 222, 223, 224, 225, 226, 227, 229, 231, 232, 233, 234, 235, 236, 237, 238, 239, 240, 241, 242, 243, 244, 245, 246
layer1
0, 0, 0, 0, 0, 0, 0, 0, 0, 0, 0, 0, 0, 0, 0, 0, 0, 0, 0, 0, 0, 0, 0, 0, 0, 0, 0, 0, 0, 0
0, 0, 0, 0, 0, 0, 0, 0, 0, 0, 0, 0, 0, 0, 0, 0, 0, 0, 0, 0, 0, 0, 0, 0, 0, 47, 50, 47, 70, 0
0, 0, 47, 47, 47, 47, 51, 47, 47, 47, 47, 47, 47, 47, 47, 47, 0, 0, 0, 0, 0, 0, 0, 0, 0, 47, 47, 47, 47, 0
0, 0, 47, 70, 47, 47, 47, 47, 47, 47, 47, 47, 47, 69, 47, 47, 0, 0, 0, 0, 0, 0, 0, 0, 0, 0, 0, 0, 0, 0
0, 0, 69, 47, 47, 47, 47, 47, 47, 47, 47, 48, 47, 47, 47, 108, 0, 0, 0, 47, 47, 47, 47, 47, 47, 47, 47, 47, 70, 47
0, 0, 47, 47, 47, 47, 47, 47, 47, 47, 47, 47, 47, 47, 47, 47, 0, 0, 0, 47, 47, 47, 47, 47, 47, 47, 47, 47, 47, 47
0, 0, 47, 47, 47, 47, 47, 47, 47, 47, 47, 47, 47, 47, 47, 47, 47, 47, 47, 47, 47, 47, 68, 47, 47, 48, 47, 108, 69, 47
0, 0, 47, 47, 47, 47, 50, 108, 47, 47, 47, 51, 47, 47, 70, 47, 47, 47, 47, 47, 47, 47, 47, 47, 47, 47, 47, 47, 47, 47
0, 0, 68, 47, 47, 47, 47, 47, 47, 47, 47, 47, 47, 47, 47, 108, 47, 47, 47, 47, 50, 47, 47, 47, 47, 47, 70, 47, 47, 70
0, 0, 47, 47, 47, 47, 47, 47, 47, 47, 47, 47, 47, 47, 47, 47, 47, 47, 47, 47, 47, 47, 47, 47, 47, 47, 47, 47, 47, 47
0, 0, 47, 70, 47, 47, 48, 47, 47, 47, 47, 47, 47, 47, 47, 47, 47, 47, 47, 47, 47, 47, 48, 47, 47, 47, 51, 47, 47, 50
0, 0, 47, 47, 47, 47, 47, 108, 47, 47, 47, 70, 47, 47, 47, 47, 47, 70, 47, 47, 68, 47, 47, 47, 47, 47, 47, 47, 48, 47
0, 0, 0, 0, 0, 0, 0, 0, 0, 0, 0, 47, 68, 47, 47, 47, 47, 47, 47, 47, 47, 47, 47, 47, 108, 108, 47, 47, 47, 47
0, 0, 0, 0, 0, 0, 0, 0, 0, 0, 0, 47, 47, 69, 47, 47, 47, 47, 68, 47, 47, 47, 47, 47, 47, 47, 47, 47, 47, 47
0, 0, 0, 0, 0, 0, 0, 0, 0, 0, 0, 47, 47, 47, 47, 47, 47, 47, 47, 47, 47, 47, 47, 47, 47, 47, 0, 0, 0, 0
0, 0, 0, 0, 0, 0, 0, 0, 0, 0, 0, 47, 47, 47, 47, 47, 47, 48, 47, 50, 47, 47, 47, 47, 47, 47, 0, 0, 0, 0
0, 0, 0, 0, 0, 0, 0, 0, 0, 0, 0, 51, 47, 47, 47, 47, 47, 47, 47, 47, 47, 47, 47, 47, 47, 47, 0, 0, 0, 0
0, 0, 0, 0, 0, 0, 0, 0, 0, 0, 0, 47, 47, 70, 47, 47, 47, 47, 0, 0, 0, 0, 0, 0, 0, 0, 0, 0, 0, 0
0, 0, 0, 0, 0, 0, 0, 0, 0, 0, 0, 0, 0, 0, 0, 0, 0, 0, 0, 0, 0, 0, 0, 0, 0, 0, 0, 0, 0, 0
0, 0, 0, 0, 0, 0, 0, 0, 0, 0, 0, 0, 0, 0, 0, 0, 0, 0, 0, 0, 0, 0, 0, 0, 0, 0, 0, 0, 0, 0
layer2
0, 0, 0, 0, 0, 0, 0, 6, 0, 0, 0, 134, 135, 0, 0, 0, 0, 0, 0, 0, 0, 0, 0, 0, 4, 40, 40, 59, 60, 5
0, 4, 40, 40, 40, 40, 40, 25, 40, 58, 40, 153, 154, 40, 40, 60, 5, 0, 0, 0, 0, 0, 0, 0, 96, 167, 0, 0, 0, 20
0, 22, 0, 0, 0, 0, 0, 0, 0, 0, 110, 0, 0, 0, 167, 0, 20, 0, 0, 0, 6, 0, 134, 135, 22, 0, 0, 0, 0, 20
0, 22, 111, 0, 0, 0, 0, 0, 0, 0, 0, 0, 0, 0, 0, 0, 20, 0, 4, 60, 25, 40, 153, 154, 40, 59, 158, 40, 40, 40
0, 22, 0, 0, 71, 0, 0, 0, 0, 0, 0, 0, 0, 0, 0, 0, 20, 6, 22, 0, 0, 110, 0, 0, 110, 0, 0, 0, 0, 110
0, 22, 0, 0, 90, 0, 0, 0, 0, 0, 0, 0, 0, 0, 0, 111, 39, 25, 41, 0, 0, 0, 0, 0, 0, 0, 0, 0, 0, 131
42, 43, 0, 0, 0, 0, 0, 0, 0, 0, 0, 0, 0, 0, 0, 0, 0, 0, 0, 0, 0, 0, 0, 0, 0, 0, 0, 0, 0, 150
0, 22, 0, 0, 0, 0, 0, 0, 187, 0, 0, 0, 0, 0, 0, 0, 0, 0, 0, 16, 0, 0, 0, 0, 0, 0, 0, 227, 0, 34
0, 22, 0, 0, 0, 0, 0, 0, 206, 128, 0, 0, 0, 0, 0, 0, 0, 0, 0, 0, 0, 0, 0, 0, 0, 0, 0, 246, 0, 14
0, 184, 85, 86, 0, 0, 0, 0, 0, 0, 0, 0, 0, 0, 0, 0, 0, 0, 0, 0, 0, 0, 0, 0, 0, 71, 0, 0, 0, 128
0, 22, 33, 0, 0, 0, 0, 0, 0, 0, 0, 0, 0, 0, 0, 0, 0, 0, 0, 0, 131, 132, 0, 0, 0, 90, 0, 0, 0, 36
42, 43, 0, 0, 0, 0, 0, 0, 0, 0, 0, 54, 0, 0, 0, 0, 0, 0, 0, 0, 150, 151, 0, 0, 0, 0, 0, 0, 0, 83
0, 23, 2, 2, 2, 44, 2, 2, 2, 2, 3, 0, 0, 0, 72, 73, 0, 0, 0, 0, 169, 170, 111, 0, 0, 0, 0, 0, 0, 110
0, 0, 0, 0, 0, 63, 0, 0, 0, 0, 22, 0, 0, 0, 91, 92, 0, 0, 0, 0, 0, 0, 0, 0, 0, 0, 0, 0, 0, 14
0, 0, 0, 0, 0, 0, 0, 0, 0, 42, 43, 0, 0, 0, 0, 0, 0, 0, 87, 0, 0, 0, 0, 0, 0, 0, 1, 2, 2, 24
0, 0, 0, 0, 0, 0, 0, 0, 0, 0, 22, 0, 0, 0, 0, 0, 0, 0, 106, 0, 72, 73, 0, 0, 0, 0, 20, 0, 0, 0
0, 0, 0, 0, 0, 0, 0, 0, 0, 0, 22, 0, 0, 0, 0, 0, 0, 0, 125, 0, 91, 92, 0, 0, 0, 33, 20, 0, 0, 0
0, 0, 0, 0, 0, 0, 0, 0, 0, 0, 22, 0, 0, 0, 17, 18, 0, 0, 164, 79, 2, 2, 186, 2, 2, 44, 24, 0, 0, 0
0, 0, 0, 0, 0, 0, 0, 0, 0, 0, 23, 141, 142, 2, 2, 80, 2, 44, 24, 0, 0, 0, 205, 0, 0, 63, 0, 0, 0, 0
0, 0, 0, 0, 0, 0, 0, 0, 0, 0, 0, 160, 161, 0, 0, 0, 0, 63, 0, 0, 0, 0, 0, 0, 0, 0, 0, 0, 0, 0
